Fecha,Descripcion,Referencia,Debito,Credito,Saldo
2025-09-26,DEPOSITO VENTANILLA,DEP001,,1500.00,6500.00
2025-09-27,PAGO PROVEEDOR ABC,PAG001,350.00,,6150.00
2025-09-28,TRF CLIENTE XYZ,TRF001,,2200.00,8350.00
2025-09-29,COMISION MANTENIMIENTO,COM001,12.50,,8337.50
2025-10-01,INTERES GANADO,INT001,,25.00,8362.50
2025-10-02,PAGO SERVICIOS BASICOS,SRV001,800.00,,7562.50
2025-10-03,COMISION TRANSFERENCIA,COM002,25.00,,7537.50